INFOCOM - IEEE INFOCOM
SIGGRAPH - Annual Conference on Computer Graphics
CVPR - Computer Vision and Pattern Recognition
VLDB - Very Large Data Bases
STOC - ACM Symposium on Theory of Computing
FOCS - IEEE Symposium on Foundations of Computer Science
CHI - Computer Human Interaction
MOBICOM - Mobile Computing and Networking
NIPS - Neural Information Processing Systems
AAAI - National Conference on Artificial Intelligence
IJCAI - International Joint Conference on Artificial Intelligence
POPL - ACM SIGPLAN-SIGACT Symposium on Principles of Programming Languages
ICCV - International Conference on Computer Vision
ICML - International Conference on Machine Learning
DAC - Design Automation Conference
SIGIR - Research and Development in Information Retrieval
KDD - Knowledge Discovery and Data Mining
ICSE - International Conference on Software Engineering
SIGMOD - International Conference on Management of Data
CRYPTO - International Crytology Conference
SIGCOMM - ACM SIGCOMM Conference
ICRA - International Conference on Robotics and Automation
WWW - World Wide Web Conference Series
ACL - Meeting of the Association for Computational Linguistics
ECCV - European Conference on Computer Vision
ICDE - International Conference on Data Engineering
EUROCRYPT - Theory and Application of Cryptographic Techniques
BioMED - Biomedical Engineering
VTC - Vehicular Technology Conference
CSCW - Conference on Computer Supported Cooperative Work
S&P - IEEE Symposium on Security and Privacy
ICASSP - International Conference on Acoustics, Speech, and Signal Processing
PODS - Symposium on Principles of Database Systems
ISCAS - IEEE International Symposium on Circuits and Systems
ICCAD - International Conference on Computer Aided Design
Storage and Retrieval for Image and Video Databases
USENIX - USENIX Technical Conference
CCS - ACM Conference on Computer and Communications Security
ICC - IEEE International Conference on Communications
ITC - International Test Conference
ISPD - International Symposium on Physical Design
SODA - ACM-SIAM Symposium on Discrete Algorithms
MICRO - International Symposium on Microarchitecture
MobiHoc - Mobile Ad Hoc Networking and Computing
CAV - Computer Aided Verification
MM - ACM Multimedia Conference
ICDCS - International Conference on Distributed Computing Systems
ICGA - International Conference on Genetic Algorithms
RTSS - IEEE Real-Time Systems Symposium
CDC - Conference on Decision and Control
PODC - Symposium on Principles of Distributed Computing
ISCA - International Symposium on Computer Architecture
AAMAS(Agents) - Autonomous Agents & Multiagent Systems/International Conference on Autonomous Agents
UAI - Uncertainty in Artificial Intelligence
SC - Supercomputing Conference
LICS - Logic in Computer Science
ISMB - Intelligent Systems in Molecular Biology
UIST - User Interface Software and Technology
ICALP - International Colloquium on Automata, Languages and Programming
ECOOP - European Conference on Object-Oriented Programming
ICIP - International Conference on Image Processing
USENIX Security Symposium
SOSP - ACM Symposium on Operating Systems Principles
SOCG - Symposium on Computational Geometry
KR - Principles of Knowledge Representation and Reasoning
ISLPED - International Symposium on Low Power Electronics and Design
IROS - International Conference on Intelligent RObots and Systems
OSDI - Operating Systems Design and Implementation
ICPR - International Conference on Pattern Recognition
TREC - Text REtrieval Conference
IEEE Visualization
ISWC - International Semantic Web Conference
FGR - IEEE International Conference on Automatic Face and Gesture Recognition
IPSN - Information Processing in Sensor Networks
SenSys - Conference On Embedded Networked Sensor Systems
HICSS - Hawaii International Conference on System Sciences
COLING - International Conference on Computational Linguistics
OR - Operations Research
CIKM - International Conference on Information and Knowledge Management
DATE - Design, Automation, and Test in Europe
HPCA - International Symposium on High-Performance Computer Architecture
NDSS - Network and Distributed System Security Symposium
CONCUR - International Conference on Concurrency Theory
Hypertext - ACM Conference on Hypertext
PLDI - SIGPLAN Conference on Programming Language Design and Implementation
CEC - IEEE Congress on Evolutionary Computation
WCNC - Wireless Communications and Networking, IEEE Conference
IPDPS(IPPS) - International Parallel and Distributed Processing Symposium/International Parallel Processing Symposium
ICS - International Conference on Supercomputing
HPDC - IEEE International Symposium on High Performance Distributed Computing
FTCS - Symposium on Fault-Tolerant Computing
ISNN - International Symposium on Neural Networks
ICME(ICMCS) - International Conference on Multimedia Computing and Systems/International Conference on Multimedia and Expo
ICNP - International Conference on Network Protocols
I3D - ACM Symposium on interactive 3D graphics
ICPP - International Conference on Parallel Processing
OOPSLA - Conference on Object-Oriented Programming Systems, Languages, and Applications
SPAA - ACM Symposium on Parallel Algorithms and Architectures
SPIN - International Workshop on Model Checking of Software
CSFW - Computer Security Foundations Workshop
CACM - Communications of The ACM
PAMI - IEEE Transactions on Pattern Analysis and Machine Intelligence
TIT - IEEE Transactions on Information Theory
PIEEE - Proceedings of The IEEE
TCOM - IEEE Transactions on Communications
AI - Artificial Intelligence
JSAC - IEEE Journal on Selected Areas in Communications
TSE - IEEE Transactions on Software Engineering
JACM - Journal of The ACM
SIGPLAN - Sigplan Notices
BIOINFORMATICS - Bioinformatics/computer Applications in The Biosciences
CCR - Computer Communication Review
COMPUTER - IEEE Computer
TC - IEEE Transactions on Computers
Sigmod Record
IEEE Transactions on Image Processing
IJCV - International Journal of Computer Vision
TSP - IEEE Transactions on Signal Processing
CSUR - ACM Computing Surveys
SIAMCOMP - Siam Journal on Computing
ACM Siggraph Computer Graphics
Math. Comput. - Mathematics of Computation
TSMC - IEEE Transactions on Systems, Man, and Cybernetics
NECO - Neural Computation
TON - IEEE/ACM Transactions on Networking
J ACOUST SOC AMER - Journal of The Acoustical Society of America
TOG - ACM Transactions on Graphics
ML - Machine Learning
Automatica
IEEE Transactions on Neural Networks
IEEE Commun. Mag. - IEEE Communications Magazine
SIGOPS - Operating Systems Review
Operations Research
EJOR - European Journal of Operational Research
ACM Sigarch Computer Architecture News
TODS - ACM Transactions on Database Systems
JCSS - Journal of Computer and System Sciences
TCS - Theoretical Computer Science
FSS - Fuzzy Sets and Systems
IEEE TRANS ROBOTICS AUTOMAT - IEEE Transactions on Robotics and Automation
IEEE Transactions on Computer-aided Design of Integrated Circuits and Systems
COMPUT METHOD APPL MECH ENG - Computer Methods in Applied Mechanics and Engineering
PR - Pattern Recognition
TCSV - IEEE Transactions on Circuits and Systems for Video Technology
IANDC - Information and Computation/information and Control
Mathematical Programming
Neural Networks
TKDE - IEEE Transactions on Knowledge and Data Engineering
IJRR - International Journal of Robotic Research
TOPLAS - ACM Transactions on Programming Languages and Systems
TOCS - ACM Transactions on Computer Systems
INT J NUMER METHOD ENG - International Journal for Numerical Methods in Engineering
CORR - Computing Research Repository
SOFTWARE - IEEE Software
TOIS - ACM Transactions on Information Systems
CVGIP - Graphical Models /graphical Models and Image Processing /computer Vision, Graphics, and Image Processing
CGA - IEEE Computer Graphics and Applications
TFS - IEEE Transactions on Fuzzy Systems
IJMMS - International Journal of Human-computer Studies / International Journal of Man-machine Studies
COLI - Computational Linguistics
TPDS - IEEE Transactions on Parallel and Distributed Systems
SIAMAM - Siam Journal on Applied Mathematics
IBMRD - Ibm Journal of Research and Development
JMLR - Journal of Machine Learning Research
SIGMETRICS - Sigmetrics Performance Evaluation Review
TEC - IEEE Transactions on Evolutionary Computation
ISR - Information Systems Research
CVIU - Computer Vision and Image Understanding
TWC - IEEE Transactions on Wireless Communications
NETWORK - IEEE Network
ACM Sigsoft Software Engineering Notes
MOR - Mathematics of Operations Research
INT J CONTR - International Journal of Control
JPDC - Journal of Parallel and Distributed Computing
Siam Journal on Scientific Computing
IVC - Image and Vision Computing
IPL - Information Processing Letters
SPE - Software, Practice and Experience
MICRO - IEEE Micro
IEEE SAP - IEEE Transactions on Speech and Audio Processing
JAIR - Journal of Artificial Intelligence Research
IBMSJ - Ibm Systems Journal
TOMS - ACM Transactions on Mathematical Software
JCT - Journal of Combinatorial Theory
PRL - Pattern Recognition Letters
IEEE Commun. Lett. - IEEE Communications Letters
JASIS - Journal of The American Society for Information Science and Technology
Algorithmica
JAL - Journal of Algorithms
BMC Bioinformatics
TVCG - IEEE Transactions on Visualization and Computer Graphics
CGF - Computer Graphics Forum
COMPUT NETW - Computer Networks
IEEE Pers. Commun. - IEEE Personal Communications
AIM - Ai Magazine
EXPERT - IEEE Expert / IEEE Intelligent Systems
IPM - Information Processing and Management
CN - Computer Networks and Isdn Systems
ACTA - Acta Informatica
INFORM MANAGEMENT - Information & Management
